Name,Volume,Ask Size,Ask Price,Bid Size,Bid Price,Last Price,Shares Matched,Shares Routed
UVXY,2345482,2800,15.79,3000,15.78,15.79,2304380,41102
VXX,2177238,2900,20.86,2900,20.85,20.86,2151359,25879
RSX,648008,200,29.98,10952,29.97,29.98,639437,8571
ARKG,635552,200,69.04,200,69.03,69.04,613878,21674
IEFA,541998,11400,76.32,17000,76.31,76.32,539371,2627
ITB,457771,300,79.10,200,79.09,79.09,452720,5051
EZU,278200,15300,50.15,8800,50.14,50.15,276872,1328
VIXY,277017,600,17.05,1400,17.04,17.06,264733,12284
IGV,251146,150,440.42,50,440.37,440.38,243962,7184
USMV,168138,1800,78.05,5200,78.04,78.06,167438,700
SVXY,144284,344,62.14,200,62.13,62.13,134730,9554
EFV,125369,3300,51.08,1740,51.07,51.07,123068,2301
INDA,124598,1900,49.61,1500,49.60,49.60,123027,1571
VLUE,119122,900,105.43,400,105.42,105.42,117615,1507
ARKQ,111202,50,86.55,200,86.53,86.55,106471,4731
PAVE,109570,7600,28.82,2879,28.81,28.82,109370,200
JPST,96344,61919,50.59,15735,50.58,50.59,96344,0
GOVT,90667,197100,26.50,166446,26.49,26.50,90119,548
IYZ,89284,700,31.53,6500,31.51,31.52,79205,10079
MTUM,77878,200,187.81,400,187.78,187.81,77775,103
IDV,76192,500,30.52,4600,30.51,30.52,65714,10478
CBOE,72223,104,129.74,1,129.66,129.65,72112,111
USHY,67899,4400,41.09,2000,41.08,41.08,63845,4054
ECH,67029,600,25.42,850,25.40,25.40,67026,3
RYLD,49692,700,25.72,958,25.71,25.70,47175,2517
REM,49510,707,36.95,1500,36.94,36.95,49458,52
MARZ,46700,7000,29.08,7000,28.97,29.00,46700,0
FLOT,46023,9534,50.75,3588,50.74,50.75,46023,0
VNM,33641,213,20.59,159,20.57,20.58,30439,3202
EFG,33376,600,112.72,100,112.70,112.70,33142,234
MOAT,31357,500,76.63,100,76.62,76.65,31349,8
QUAL,31039,300,145.74,600,145.72,145.70,31039,0
PICK,30090,85,41.12,300,41.07,41.11,28004,2086
NOBL,27829,36,95.90,900,95.88,95.90,27609,220
EFAV,27811,800,77.25,200,77.24,77.24,27192,619
HYD,23115,1904,62.33,307,62.32,62.32,22092,1023
ITA,20537,8,104.50,400,104.48,104.51,20338,199
OILK,20262,1600,54.43,1600,54.37,54.35,20262,0
NEAR,20216,1909,50.03,21435,50.02,50.03,20216,0
ARKX,19646,1700,20.54,3615,20.52,20.50,19364,282
IGE,19251,1500,31.25,1800,31.24,31.23,19201,50
BBEU,19195,1100,59.66,400,59.64,59.64,17872,1323
IFRA,19070,300,37.48,41,37.46,37.44,17971,1099
SMB,18965,700,17.93,600,17.91,17.92,18965,0
SLVP,18186,1200,14.39,521,14.34,14.36,18186,0
BBJP,16851,1000,58.30,500,58.26,58.26,15448,1403
CEMB,14125,800,51.32,792,51.30,51.30,12665,1460
ACWV,13961,1100,107.02,1000,106.96,107.00,13961,0
HEGD,13716,1800,19.50,4200,19.39,19.45,13716,0
BBAX,13341,3000,55.48,100,55.46,55.43,11741,1600
DRSK,11909,3000,29.22,3600,29.17,29.24,11909,0
GSST,11790,453,50.58,2203,50.57,50.58,6890,4900
GOVZ,11727,3592,22.21,3931,22.18,22.15,11727,0
BBCA,11248,500,68.31,1000,68.28,68.29,11248,0
IAGG,10902,1000,55.34,1362,55.32,55.33,10897,5
ICVT,10883,600,101.14,24,101.03,101.11,10883,0
IEO,10629,100,60.57,2000,60.54,60.53,10328,301
XBTF,10530,3200,58.21,1,57.91,58.00,7085,3445
FNOV,10401,400,38.60,965,38.56,38.58,10401,0
VSGX,9897,100,63.67,149,63.65,63.63,8697,1200
HEFA,9723,600,36.01,1200,36.00,36.01,9723,0
SMIN,9671,100,61.34,700,61.21,61.21,9671,0
ESGV,9528,200,87.93,800,87.90,87.87,9528,0
FBCG,9137,1800,36.54,100,36.43,36.45,9067,70
FCPI,8833,200,33.16,100,33.12,33.10,8833,0
CNYA,8575,1000,43.36,9,43.30,43.32,8065,510
COWZ,8151,5700,46.34,600,46.31,46.32,8151,0
BUFR,8132,100,23.82,1048,23.77,23.79,8132,0
OGIG,7936,200,56.79,900,56.72,56.73,7936,0
FDRV,7733,1000,29.86,1000,29.80,29.72,7608,125
EMHY,7701,1024,43.48,800,43.47,43.48,5244,2457
VUSB,7682,1950,50.04,4202,50.03,50.04,6182,1500
IQDG,7603,1000,39.75,1100,39.71,39.69,7303,300
FJUL,7316,3000,36.28,3000,36.21,36.22,7316,0
JMST,7299,582,51.00,1030,50.99,51.00,7299,0
IGHG,7292,100,75.28,400,74.97,74.94,7292,0
EEMV,7237,100,63.89,19,63.85,63.96,7237,0
TOKE,7219,307,13.55,752,13.40,13.40,4070,3149
PAWZ,7195,700,81.35,25,81.23,81.25,7195,0
ICF,7148,300,71.21,1600,71.19,71.00,7148,0
ICSH,7138,3239,50.44,28750,50.43,50.44,7138,0
SVAL,6791,1200,32.60,1130,32.56,32.52,6790,1
GSEW,6728,700,71.73,900,71.69,71.69,6728,0
PNOV,6661,600,30.77,500,30.73,30.75,5747,914
EMGF,6655,351,51.76,1000,51.73,51.73,4655,2000
BBUS,6456,900,85.96,300,85.94,85.96,6456,0
BBIN,6449,100,60.56,800,60.53,60.54,6449,0
ITM,6247,800,51.25,400,51.23,51.23,6247,0
BUFD,6123,5400,21.22,1460,21.16,21.20,3623,2500
IYLD,5984,9,23.90,3200,23.87,23.87,5984,0
GTIP,5961,700,59.14,721,59.13,59.14,5961,0
WFHY,5943,600,52.21,600,52.15,52.18,5943,0
FBCV,5860,100,29.19,871,29.13,29.16,4680,1180
FGRO,5770,1100,22.11,1000,22.10,22.08,5770,0
JCPB,5566,600,54.48,600,54.39,54.48,5566,0
DNOV,5245,400,35.14,355,35.08,35.11,5245,0
EWUS,5095,1300,47.06,1300,46.91,47.03,5095,0
GVI,5061,253,114.27,10,114.23,114.23,5061,0
IYT,5008,300,273.44,6,273.35,273.32,5008,0
EDEN,4957,1400,112.49,900,112.28,112.48,4957,0
VFQY,4891,600,128.30,1400,128.21,128.14,4891,0
PRNT,4781,500,36.66,1305,36.52,36.60,4781,0
BUFG,4659,300,20.23,100,20.22,20.24,4259,400
ENOR,4658,781,29.87,1000,29.82,29.80,4658,0
NURE,4578,1000,38.36,31,38.32,38.14,4178,400
PTLC,4553,200,41.31,5186,41.28,41.30,4553,0
XJH,4464,1400,39.49,1100,39.42,39.45,4464,0
NUSC,4416,200,46.54,351,46.49,46.35,4416,0
MDEV,4230,1000,26.43,1000,26.30,26.30,4230,0
FLDR,4215,1200,50.77,30,50.75,50.77,2315,1900
VOTE,4182,1100,55.70,1119,55.68,55.67,4182,0
JPIB,4161,700,50.84,728,50.82,50.82,2781,1380
TAIL,4075,700,18.06,1201,18.00,18.01,4075,0
PTMC,3932,600,36.85,300,36.81,36.82,3832,100
FJUN,3900,400,37.73,100,37.63,37.70,3900,0
FLBL,3702,700,24.97,100,24.94,24.96,3702,0
ESML,3691,200,41.62,64,41.58,41.45,3691,0
FOCT,3603,400,35.40,200,35.27,35.41,3603,0
LVHI,3557,300,26.07,500,26.00,26.04,3557,0
CALF,3524,1200,46.17,900,46.12,45.95,3424,100
SMMV,3512,500,38.92,25,38.88,38.92,3512,0
IVAL,3498,300,26.71,300,26.66,26.77,3498,0
PAUG,3398,3000,30.21,71,30.17,30.18,3398,0
OUSA,3375,400,44.75,400,44.73,44.75,3375,0
LEAD,3167,500,60.21,500,60.17,60.16,3167,0
FSEP,3066,3000,35.68,2500,35.64,35.69,3066,0
IYJ,2974,500,111.80,259,111.75,111.74,2974,0
IZRL,2925,63,30.49,100,30.41,30.42,2826,99
DDLS,2907,600,34.99,600,34.92,35.00,2907,0
SMMD,2902,100,68.44,500,68.31,68.38,2902,0
VCEB,2879,700,73.74,600,73.71,73.68,2879,0
FCLD,2822,1000,26.91,1001,26.85,26.85,2338,484
BBRE,2779,100,105.79,300,105.74,105.71,2679,100
BMAY,2759,3000,32.89,3000,32.81,32.84,2759,0
HSRT,2698,1600,40.79,100,40.70,40.72,2698,0
OMFL,2603,400,50.13,300,50.10,50.04,2603,0
KNG,2595,500,56.02,1000,55.88,55.96,2595,0
OMFS,2521,500,43.92,500,43.83,43.80,2521,0
GVAL,2471,300,22.99,700,22.92,23.00,2471,0
MAGA,2445,300,38.73,300,38.65,38.69,2145,300
JEMA,2438,1000,48.32,2000,48.23,48.35,2438,0
FLHY,2394,343,26.20,2,26.17,26.19,2394,0
EYLD,2376,1600,35.81,100,35.30,35.76,2376,0
MSMR,2368,9500,25.26,9700,25.23,25.27,2368,0
SECT,2356,2500,44.52,2700,44.46,44.53,2356,0
SHYD,2356,600,25.02,700,24.99,25.00,2356,0
QVAL,2332,300,38.50,1000,38.44,38.42,2332,0
DFNL,2300,900,31.38,1,31.34,31.34,2300,0
JPHY,2276,100,51.58,800,51.55,51.57,2076,200
FRNW,2269,1550,28.10,1105,28.03,28.00,2269,0
MSVX,2231,1600,24.90,1600,24.81,24.87,2231,0
SYLD,2228,500,65.96,300,65.86,65.94,2028,200
NULG,2186,200,73.85,300,73.79,73.80,2178,8
IVSG,2183,100,14.84,100,14.82,14.86,2183,0
BUYZ,2144,1600,50.92,1200,50.84,50.80,2144,0
REGL,2102,500,73.19,400,73.14,73.20,2102,0
VIXM,2066,400,30.95,3300,30.88,30.96,2066,0
TMFC,2021,100,44.71,300,44.67,44.66,1646,375
NUMV,2014,300,38.94,300,38.91,38.90,2014,0
KJAN,2000,400,31.99,3000,31.91,31.91,2000,0
VFVA,1975,200,104.47,200,104.38,104.32,1975,0
SATO,1947,100,29.99,1000,29.95,29.94,1147,800
LQDI,1945,600,30.95,1617,30.92,30.95,1845,100
NUMG,1912,300,58.61,400,58.53,58.54,1848,64
DWLD,1865,700,30.87,600,30.80,30.81,1865,0
FLQL,1851,200,45.87,4500,45.83,45.84,1851,0
DFEB,1800,900,35.11,5000,35.07,35.07,1800,0
FDHT,1709,1000,26.66,104,26.65,26.68,1161,548
FPFD,1702,2411,25.05,4,25.04,25.05,1702,0
NULV,1689,700,39.33,300,39.32,39.36,1689,0
FMIL,1648,100,29.42,1600,29.35,29.35,1648,0
SMDV,1618,500,66.37,200,66.32,66.33,1618,0
VFMO,1613,1000,138.84,1000,138.72,138.70,1313,300
XMPT,1575,240,29.31,1,29.30,29.35,1575,0
IBHF,1574,75,25.38,10,25.25,25.38,1574,0
BUFT,1569,729,20.10,500,20.07,20.09,1569,0
BGLD,1565,100,19.44,200,19.40,19.41,1565,0
FPRO,1469,1000,25.61,1000,25.59,25.50,1469,0
EPRF,1452,300,23.83,2,23.77,23.80,1452,0
IETC,1435,400,62.60,400,62.56,62.70,1435,0
MLN,1424,1,21.60,700,21.59,21.62,224,1200
DUSA,1405,700,35.20,700,35.10,35.14,1405,0
CEFS,1389,300,21.94,65,21.85,21.90,1389,0
GMOM,1376,300,30.41,300,30.28,30.39,1376,0
TYA,1349,600,24.66,900,24.62,24.67,1349,0
BNOV,1302,300,32.61,100,32.53,32.56,1302,0
YPS,1261,7000,24.30,7000,24.24,24.31,1261,0
PTEU,1218,341,25.31,300,25.19,25.24,1218,0
DINT,1203,900,20.75,74,20.64,20.64,1203,0
CSM,1132,500,109.31,500,109.19,109.25,1132,0
IGLD,1102,100,20.62,100,20.48,20.58,1102,0
MBCC,1102,500,30.02,500,29.99,30.09,1102,0
OUSM,1087,934,37.13,600,37.09,37.13,1086,1
FDG,1077,1000,88.23,4400,88.08,88.02,1077,0
HYIN,1055,500,25.36,500,25.31,25.31,1055,0
NOCT,1042,400,40.62,500,40.53,40.56,1042,0
IQM,1015,3452,57.98,1600,57.88,57.90,1015,0
XSHQ,1003,300,40.50,1000,40.38,40.37,903,100
MSTB,1001,1800,32.78,1100,32.70,32.75,1001,0
MPRO,1000,500,27.24,500,27.22,27.26,1000,0
DFNV,994,200,31.19,1800,31.13,31.21,994,0
TILT,963,900,182.89,100,182.79,182.62,963,0
NUEM,921,400,34.42,300,34.23,34.36,921,0
PTNQ,920,700,59.68,700,59.65,59.70,920,0
GCOW,910,900,30.13,1200,30.06,30.02,910,0
NOVZ,844,3000,33.22,50,33.16,33.22,844,0
FSMO,825,1200,24.70,1000,24.66,24.70,825,0
XDAT,825,5500,30.13,7,30.09,30.30,825,0
RESD,822,1000,31.34,1000,31.31,31.41,822,0
ESG,817,500,115.16,10,115.09,114.92,817,0
FFEB,800,3,38.10,7200,38.06,38.06,800,0
FMAG,800,1000,25.71,1100,25.68,25.73,800,0
FDEC,784,100,34.18,400,34.17,34.17,784,0
BSEP,759,300,33.09,300,33.01,33.04,759,0
DUDE,728,1100,30.60,2100,30.53,30.63,728,0
ACIO,716,6000,32.06,6600,32.01,32.03,716,0
TTAC,709,1600,59.05,1177,58.97,59.02,709,0
FRDM,693,900,33.10,17,33.00,33.17,693,0
GAA,690,300,31.98,700,31.90,31.98,690,0
IBHA,682,200,24.18,298,24.10,24.19,682,0
NUDM,670,1200,32.58,300,32.47,32.62,670,0
TDV,667,500,65.27,500,65.21,65.42,667,0
GOAT,665,1000,39.86,1000,39.83,39.84,665,0
DDWM,645,1000,30.61,1000,30.55,30.60,645,0
DFND,644,1502,42.29,1599,42.22,42.27,644,0
AESR,630,400,14.90,400,14.86,14.85,630,0
EGIS,625,1400,35.20,1400,35.17,35.22,625,0
NAPR,620,50,38.69,200,38.55,38.56,620,0
MFMS,610,2500,38.75,800,38.53,38.81,610,0
XVV,603,500,36.39,1100,36.36,36.41,603,0
ZECP,586,1316,26.06,2900,25.94,26.07,586,0
PSMB,582,500,17.25,100,17.19,17.24,582,0
DJUL,563,3000,33.54,3000,33.46,33.55,563,0
TRTY,563,100,27.98,100,27.90,27.94,563,0
IEME,550,400,34.88,400,34.83,34.77,550,0
MOTI,550,300,34.00,35,33.93,33.99,550,0
PEX,534,500,37.80,500,37.70,37.79,534,0
BBSA,530,600,51.17,700,51.15,51.20,530,0
WUGI,530,1000,69.09,1,69.00,69.22,380,150
UNOV,510,1300,29.49,100,29.41,29.48,500,10
GHYG,498,700,49.33,100,49.22,49.20,398,100
DAUG,492,1000,35.20,500,35.10,35.15,492,0
PBUS,492,1300,47.96,16,47.87,47.80,492,0
OEUR,471,90,29.09,600,29.05,29.15,471,0
FYLD,447,300,27.01,105,27.00,27.00,447,0
FLV,444,1100,60.68,19,60.61,60.57,444,0
FAPR,428,100,32.29,433,32.24,32.30,428,0
IAUF,425,100,56.57,100,56.43,56.48,425,0
IBHD,421,329,24.58,428,24.50,24.54,421,0
FDEM,415,100,26.30,700,26.01,26.07,415,0
IGRO,403,19,67.46,400,67.24,67.34,403,0
HYDB,401,600,51.44,20,51.42,51.43,401,0
USMF,400,1600,40.96,100,40.94,40.92,400,0
IEHS,376,500,43.60,500,43.56,43.57,376,0
IMOM,376,300,35.20,300,35.07,35.17,376,0
IDME,372,500,24.92,300,24.88,24.95,372,0
PWS,371,1300,34.95,1000,34.90,34.92,371,0
OSCV,369,700,35.38,233,35.34,35.35,369,0
EFAD,364,520,47.46,800,47.34,47.44,364,0
NJAN,355,50,42.26,3200,42.21,42.25,355,0
TTAI,350,1600,37.20,1600,37.12,37.28,350,0
ADME,344,6000,42.74,6000,42.70,42.80,344,0
LUXE,344,2000,33.04,1600,32.92,32.99,344,0
XJR,311,1700,41.70,1300,41.62,41.63,311,0
FFHG,305,1200,37.80,1500,37.68,37.68,305,0
BMAR,302,100,34.34,800,34.24,34.33,302,0
HELX,302,100,51.01,100,50.91,50.80,302,0
FFSG,301,300,37.86,1500,37.75,37.75,301,0
IBHE,301,100,24.88,196,24.82,24.87,301,0
DMAY,300,100,34.59,3000,34.49,34.55,300,0
MEAR,300,327,50.14,500,50.10,50.11,300,0
PSCJ,300,300,21.11,300,21.06,21.11,300,0
PSMG,300,100,19.14,400,19.10,19.12,300,0
WLDR,300,300,27.87,300,27.55,27.91,300,0
KJUL,285,400,26.92,600,26.80,26.87,285,0
FCTR,281,500,36.61,1100,36.56,36.67,281,0
DIVB,279,600,41.67,100,41.64,41.70,279,0
PBEE,275,300,28.65,300,28.52,28.70,275,0
NULC,274,500,43.77,500,43.74,43.76,274,0
VAMO,266,100,26.67,3700,26.59,26.65,266,0
HCRB,250,600,41.00,600,40.96,40.98,250,0
PBSM,249,300,40.92,300,40.82,40.85,249,0
VXZ,244,300,25.99,800,25.92,26.22,244,0
IVRA,243,1000,15.01,152,15.00,15.00,243,0
UAUG,236,4700,29.20,7000,29.10,29.20,236,0
BJAN,235,500,37.10,3200,37.06,37.08,235,0
SLT,226,500,43.57,500,43.53,43.59,226,0
GSUS,221,2000,65.51,24,65.46,65.51,221,0
IVDG,219,100,14.42,100,14.40,14.37,219,0
BDEC,208,6000,34.18,900,34.12,34.14,208,0
DSEP,207,8500,33.00,600,32.93,32.96,207,0
DURA,204,200,31.00,200,30.98,31.03,204,0
FFTI,204,1200,23.92,3300,23.87,23.88,204,0
IBHC,202,230,24.56,100,24.54,24.54,202,0
ICOW,202,500,31.09,800,31.00,31.11,202,0
PFEB,202,200,29.10,3200,29.04,29.06,202,0
EMTL,201,600,50.13,600,50.09,50.13,201,0
FLQS,201,600,41.43,100,41.37,41.32,201,0
ALTS,200,500,39.43,500,39.27,39.27,200,0
BAPR,200,100,33.07,400,33.00,33.02,200,0
BJUL,200,300,33.07,300,32.97,33.05,200,0
BLKC,200,300,28.37,800,28.32,28.47,200,0
EURZ,200,1000,27.43,1000,27.40,27.49,200,0
FMAY,200,41,37.91,3000,37.88,37.91,200,0
IBMM,200,851,26.86,700,26.82,26.83,200,0
PDEC,200,400,31.07,5200,30.95,31.04,200,0
UAPR,200,400,26.22,300,26.11,26.22,200,0
VIRS,200,500,35.10,500,35.07,35.07,200,0
IDHD,199,200,26.82,1,26.77,26.76,199,0
ROMO,199,100,30.02,3600,29.94,29.93,199,0
FAIL,198,50,22.93,242,21.50,21.58,198,0
EAOA,192,300,34.71,300,34.68,34.74,192,0
TMDV,183,600,49.31,600,49.26,48.95,183,0
HEEM,181,500,30.93,1000,30.87,30.93,81,100
LKOR,180,600,60.60,100,60.57,60.45,180,0
BOSS,176,1450,36.69,1700,36.61,36.83,176,0
RESE,176,600,36.02,600,35.87,36.04,176,0
UJAN,166,100,31.54,3200,31.46,31.47,166,0
IBMO,164,700,26.85,700,26.81,26.84,164,0
MRSK,164,100,33.36,600,33.25,33.30,164,0
EWGS,158,300,81.78,300,81.61,81.45,158,0
IEIH,156,400,35.12,400,35.08,35.00,156,0
PSMC,151,900,13.99,5311,13.95,13.95,151,0
FDEV,150,100,29.89,700,29.70,29.90,150,0
TMAT,144,200,23.43,446,23.38,23.45,144,0
UOCT,143,3500,28.47,42,28.38,28.46,143,0
VFMF,137,1000,108.13,1000,108.01,107.95,37,100
EOPS,131,1600,28.31,1600,28.18,28.27,131,0
LYFE,131,1400,32.99,1400,32.96,32.95,131,0
EAOR,122,300,31.96,300,31.93,31.96,122,0
AGT,121,700,27.78,600,27.74,27.95,121,0
HYHG,109,100,62.98,200,62.50,62.70,109,0
PSFF,109,3000,22.70,1,22.60,22.68,109,0
BLDG,106,800,32.88,200,32.73,32.87,106,0
FEDX,104,1,28.20,3000,28.15,28.18,104,0
SPMV,103,400,40.19,100,40.12,40.16,103,0
DFHY,101,1600,24.66,1600,24.63,24.63,101,0
GLDB,101,1600,24.75,1700,24.40,24.82,101,0
POCT,101,3500,30.31,500,30.20,30.23,101,0
ATMP,100,300,16.08,400,16.05,16.04,100,0
BUFF,100,600,35.77,1,35.72,35.75,100,0
EMSH,100,200,72.35,200,72.14,72.18,100,0
EUCG,100,3600,27.66,1000,27.60,27.65,100,0
FLQM,100,2500,47.84,200,47.74,47.86,100,0
HFGO,100,100,19.74,100,19.72,19.83,100,0
KAPR,100,143,28.12,200,28.03,28.10,100,0
MINN,100,1900,25.08,300,25.00,25.03,100,0
SFIG,100,600,50.95,600,50.86,50.94,100,0
XDSQ,100,4500,28.60,3000,28.53,28.60,100,0
ESGG,97,300,151.88,500,151.56,152.12,97,0
KNGS,91,1600,29.52,1600,29.31,29.56,41,50
ISVL,83,1000,36.86,1000,36.78,36.90,83,0
TCTL,72,2900,34.51,2900,34.44,34.46,72,0
EMDV,66,100,58.30,1600,57.64,58.17,66,0
PJAN,66,500,33.23,200,33.14,33.21,66,0
EFNL,65,500,47.53,3,47.40,47.53,65,0
IGEB,65,600,53.59,53,53.56,53.58,65,0
QMOM,65,500,55.45,500,55.38,55.48,65,0
PSMJ,62,300,21.20,200,21.16,21.17,62,0
JMUB,57,800,54.95,700,54.93,54.94,57,0
VFLQ,57,1100,116.95,1500,116.81,116.77,57,0
RSXJ,55,200,37.90,90,37.69,37.70,55,0
TSOC,54,400,32.27,400,32.12,32.16,54,0
FOMO,52,1600,25.76,1800,25.70,25.75,52,0
IVLC,51,100,15.18,100,15.16,15.18,51,0
OCTZ,50,1000,32.40,4000,32.30,32.34,50,0
SEPZ,50,8000,32.05,3000,31.94,32.00,50,0
HYXU,47,600,53.80,500,53.69,53.82,47,0
PSEP,42,300,30.22,47,30.18,30.17,42,0
FUNL,39,500,34.73,500,34.69,34.61,39,0
PJUN,39,100,32.04,200,31.95,32.00,39,0
PSFD,39,38,24.05,100,24.04,24.05,39,0
QPFF,38,100,41.15,100,41.03,41.10,38,0
PLRG,37,349,28.70,1800,28.63,28.71,37,0
PAPR,35,600,29.24,300,29.17,29.23,35,0
QCON,31,500,49.71,700,49.68,49.81,31,0
IECS,30,400,32.94,400,32.92,32.95,30,0
XSHD,28,800,22.69,800,22.66,22.62,28,0
IEFN,25,400,33.36,400,33.33,33.50,25,0
WDNA,25,1000,25.04,1000,24.92,24.77,25,0
SULR,24,500,35.49,500,35.37,35.05,24,0
IBML,21,800,25.97,770,25.94,25.95,21,0
VFMV,20,1000,103.84,1000,103.75,104.10,20,0
BOCT,17,3300,34.31,3000,34.20,34.33,17,0
QLC,17,300,51.37,300,51.32,51.48,17,0
IEDI,16,600,48.97,600,48.94,49.00,16,0
PBTP,15,700,26.89,700,26.88,26.94,15,0
KOCT,12,500,27.86,157,27.78,27.81,12,0
SHAG,10,700,50.71,700,50.68,50.72,10,0
USEQ,5,100,38.53,300,38.44,38.45,5,0
VMOT,5,700,28.28,700,28.21,28.44,5,0
ACSI,4,4500,53.59,4500,53.54,53.49,4,0
BALT,4,400,25.91,300,25.87,25.91,4,0
MAMB,4,600,25.39,600,25.37,25.36,4,0
AFIF,3,3700,9.64,1600,9.62,9.61,3,0
HYMU,3,500,26.36,600,26.33,26.37,3,0
IMLP,3,500,12.82,600,12.78,12.84,3,0
STLG,3,700,40.84,700,40.80,40.71,3,0
UMAR,3,300,29.72,300,29.62,29.63,3,0
ALFA,2,1300,87.67,1200,87.56,87.94,2,0
CBTG,2,300,21.29,300,21.24,21.27,2,0
EUDV,2,100,54.88,100,54.77,54.82,2,0
PMAR,2,1400,31.46,300,31.36,31.33,2,0
QTJL,2,400,28.20,200,28.05,28.19,2,0
APXH,1,1600,10.02,1600,9.99,10.00,1,0
DJUN,1,100,34.35,300,34.28,34.29,1,0
ESCR,1,100,22.07,1600,22.00,22.18,1,0
FFTG,1,200,30.73,300,30.67,30.74,1,0
FIBR,1,501,99.77,600,99.69,99.78,1,0
IMFL,1,100,26.31,100,26.25,26.28,1,0
KWT,1,200,36.44,100,36.25,36.39,1,0
LSLT,1,700,32.11,700,32.09,32.11,1,0
QSPT,1,400,21.02,5000,20.93,21.01,1,0
SMI,1,600,49.92,1100,49.89,49.94,1,0
XDQQ,1,89,30.33,3600,30.27,30.36,1,0
ADFI,0,400,9.65,400,9.62,0.00,0,0
AMER,0,1600,31.93,1600,31.85,0.00,0,0
APRZ,0,6000,28.17,50,28.10,0.00,0,0
ARCM,0,1700,100.07,1600,99.87,0.00,0,0
AUGZ,0,5000,33.37,3000,33.29,0.00,0,0
AVDG,0,1600,32.87,1600,32.83,0.00,0,0
AVDR,0,1600,32.15,1600,32.11,0.00,0,0
BAUG,0,5200,33.08,3000,32.99,0.00,0,0
BFEB,0,3500,31.87,3499,31.77,0.00,0,0
BJUN,0,100,34.23,200,34.16,0.00,0,0
BOB,0,1000,27.94,1,27.90,0.00,0,0
CFCV,0,1600,36.41,1600,36.32,0.00,0,0
DALT,0,400,10.84,500,10.81,0.00,0,0
DAPR,0,100,31.43,400,31.37,0.00,0,0
DBJA,0,100,28.27,100,28.22,0.00,0,0
DBOC,0,300,30.07,300,29.96,0.00,0,0
DDEC,0,400,32.48,300,32.40,0.00,0,0
DECZ,0,3000,30.45,3000,30.37,0.00,0,0
DJAN,0,100,32.19,300,32.11,0.00,0,0
DMAR,0,100,31.76,300,31.70,0.00,0,0
DOCT,0,400,32.94,200,32.82,0.00,0,0
DSJA,0,100,30.13,100,30.00,0.00,0,0
DSOC,0,400,33.14,400,33.02,0.00,0,0
EAOK,0,300,28.08,300,28.05,0.00,0,0
EAOM,0,300,29.35,300,29.32,0.00,0,0
ESEB,0,1600,21.24,100,21.14,0.00,0,0
ESHY,0,1600,21.06,404,20.98,0.00,0,0
FAUG,0,900,38.41,500,38.28,0.00,0,0
FEBZ,0,2000,29.86,50,29.82,0.00,0,0
FJAN,0,800,33.96,5,33.88,0.00,0,0
FLIA,0,100,25.14,600,25.13,0.00,0,0
FMAR,0,200,32.91,300,32.86,0.00,0,0
FUT,0,600,40.88,600,40.67,0.00,0,0
GHTA,0,1600,24.64,100,24.53,0.00,0,0
GSEE,0,1000,52.91,1000,52.80,0.00,0,0
GSID,0,1000,57.04,1000,56.93,0.00,0,0
HEET,0,2300,26.08,300,26.02,0.00,0,0
HSUN,0,600,39.57,600,39.54,0.00,0,0
IBHB,0,221,24.21,342,24.13,0.00,0,0
IBHG,0,3000,24.79,3000,24.74,0.00,0,0
IBMN,0,800,27.87,1420,27.84,0.00,0,0
IBMP,0,900,26.97,600,26.92,0.00,0,0
IBMQ,0,1000,27.21,600,27.16,0.00,0,0
JANZ,0,3000,30.20,50,30.15,0.00,0,0
JULZ,0,3000,34.90,3000,34.77,0.00,0,0
JUNZ,0,10000,27.28,5,27.22,0.00,0,0
LIV,0,1600,29.46,1600,29.39,0.00,0,0
MAAX,0,3000,24.83,600,24.76,0.00,0,0
MAYZ,0,3000,27.35,50,27.28,0.00,0,0
MBBB,0,600,24.98,700,24.96,0.00,0,0
MBND,0,100,29.91,100,29.86,0.00,0,0
MFUL,0,1600,24.90,1600,24.83,0.00,0,0
MIG,0,700,24.86,700,24.84,0.00,0,0
MOHR,0,1600,25.79,1600,25.73,0.00,0,0
MOTE,0,600,27.29,700,27.25,0.00,0,0
MRGR,0,600,41.68,38,41.62,0.00,0,0
NJUL,0,400,48.31,500,48.11,0.00,0,0
NUDV,0,700,25.88,1400,25.86,0.00,0,0
OBND,0,900,30.04,600,29.98,0.00,0,0
PBDM,0,100,29.67,500,29.54,0.00,0,0
PBND,0,600,25.82,600,25.75,0.00,0,0
PJUL,0,337,30.63,300,30.55,0.00,0,0
PLTL,0,300,27.30,300,27.23,0.00,0,0
PMAY,0,3500,30.46,5200,30.34,0.00,0,0
PSCQ,0,300,21.01,300,20.96,0.00,0,0
PSCW,0,6000,21.90,3000,21.81,0.00,0,0
PSCX,0,6000,22.37,5,22.35,0.00,0,0
PSFJ,0,300,21.54,300,21.48,0.00,0,0
PSFM,0,100,22.97,109,22.93,0.00,0,0
PSFO,0,300,21.48,300,21.42,0.00,0,0
PSMD,0,3000,22.84,3000,22.73,0.00,0,0
PSMM,0,100,15.89,100,15.84,0.00,0,0
PSMO,0,300,21.12,300,21.06,0.00,0,0
PSMR,0,600,22.12,3000,22.06,0.00,0,0
PXUS,0,300,25.40,300,25.29,0.00,0,0
QDEC,0,8000,23.04,3200,22.93,0.00,0,0
QJUN,0,3000,21.42,200,21.33,0.00,0,0
QMAR,0,100,22.64,500,22.54,0.00,0,0
QTAP,0,400,29.98,200,29.85,0.00,0,0
QTOC,0,200,26.34,80,26.26,0.00,0,0
RDFI,0,4000,29.54,100,29.51,0.00,0,0
REC,0,500,24.70,500,24.67,0.00,0,0
RODE,0,2000,28.82,500,28.71,0.00,0,0
RODI,0,100,126.50,100,125.31,0.00,0,0
RTAI,0,1600,28.09,2700,28.02,0.00,0,0
RULE,0,1600,25.63,1600,25.56,0.00,0,0
STLV,0,1000,29.85,1000,29.81,0.00,0,0
STOT,0,500,49.27,600,49.26,0.00,0,0
TBJL,0,300,24.52,300,24.42,0.00,0,0
TEGS,0,2300,30.85,3000,30.79,0.00,0,0
TFJL,0,300,23.91,400,23.82,0.00,0,0
THY,0,52,24.64,1600,24.61,0.00,0,0
TSJA,0,1000,29.64,300,29.58,0.00,0,0
UDEC,0,10,29.82,3300,29.77,0.00,0,0
UFEB,0,293,27.89,3200,27.86,0.00,0,0
UJUL,0,100,27.57,300,27.50,0.00,0,0
UJUN,0,400,29.34,400,29.24,0.00,0,0
UMAY,0,3000,28.69,2323,28.66,0.00,0,0
USEP,0,300,28.58,600,28.51,0.00,0,0
VWID,0,1000,28.55,1000,28.52,0.00,0,0
WFIG,0,600,54.15,700,54.12,0.00,0,0
WIL,0,5,115.92,1,105.73,0.00,0,0
XBAP,0,3500,27.30,3000,27.19,0.00,0,0
XBJL,0,3500,26.79,100,26.70,0.00,0,0
XBOC,0,3500,25.02,3500,24.92,0.00,0,0
XDAP,0,100,28.62,3000,28.58,0.00,0,0
XDJL,0,3500,27.65,3500,27.53,0.00,0,0
XDOC,0,3500,25.60,3500,25.51,0.00,0,0
XJUN,0,5000,30.50,4000,30.36,0.00,0,0
XTAP,0,100,28.50,300,28.42,0.00,0,0
XTJL,0,200,27.53,200,27.37,0.00,0,0
XTOC,0,200,25.59,200,25.45,0.00,0,0
YDEC,0,400,21.93,200,21.81,0.00,0,0
YJUN,0,500,20.35,200,20.26,0.00,0,0
YMAR,0,500,21.05,300,20.95,0.00,0,0
YSEP,0,400,20.06,200,19.99,0.00,0,0